0000000000000000000-
1100000000000000000-
0111111000000000000-
0000001000000000000-
0000001000000000000-
0000001000000000000-
0000001111111111110-
0000000000000000011-
0000000000000000000